1111111111111
10010000000C1
10P0011111001
10P011E000E01
1111111111111