1111111111111
10010000000C1
100001111101
1P0011E0001
11111111111