1111111111111
10010100000C1
1000010000001
1P0001E000001
1111111111111