1111111111111
10010000001C1
1000000000011
1P0001E100001
1111111111111