1111111111111
10010000000C1
1000001000001
1P0001E100001
1111111111111