1111111111111
10010000000C1
1000000000001
1P0000E0D0001
1111111111111