1111111111111
10010000000C1
10D0011111001
100011E000E01
1111111111111