1111111111111
10010000000C1
1100000000001
1P1000E0D0001
1111111111111