1111111111111
100100000D0C1
100001111101
1P0011E0001
11111111111