1111111111111
1001C0D0000C1
1C00011111001




1P0011E000001
1111111111111