1111111111111
1001C000000C1
1C00001111001
1P0011E0D0001
1111111111111