1111111111111
10010000001C1
10000D0000011
1P0001E100001
1111111111111